Tazamir|"Tazamir"
antiviral|"antiviral"
ATAQUES |"ATAQUES "
infecci|"infecci"
neumon|"neumon"
Somnolencia|"Somnolencia"
cerco_sanitario|"cerco sanitario"
investig|"investig"
marea|"marea"
tamiflu|"tamiflu"
Seca|"Seca"
ambient|"ambient"
bronquitis|"bronquitis"
falta|"falta"
secretario_de_salud|"secretario de salud"
guata|"guata"
ahogada|"ahogada"
contagi|"contagi"
fiebr|"fiebr"
contact|"contact"
vick|"vick"
clinic|"clinic"
respirator|"respirator"
mañosa|"mañosa"
PANZA_FLOJA|"PANZA FLOJA"
ministerio|"ministerio"
aliment|"aliment"
acelerado|"acelerado"
musculares|"musculares"
dolor|"dolor"
medicin|"medicin"
Deshidratación|"Deshidratación"
sudoracion|"sudoracion"
Afiebrada|"Afiebrada"
efect|"efect"
piña|"piña"
Taquicardia|"Taquicardia"
resfrio|"resfrio"
catarro|"catarro"
sanitari|"sanitari"
escalafrios|"escalafrios"
condicion|"condicion"
h5n1|"h5n1"
Presión_arterial_baja|"Presión arterial baja"
cabez|"cabez"
contamin|"contamin"
inviern|"inviern"
Floja|"Floja"
mutacion|"mutacion"
ah1n1|"ah1n1"
detect|"detect"
inmunolog|"inmunolog"
proteg|"proteg"
recib|"recib"
tratamient|"tratamient"
fatiga|"fatiga"
Churretera|"Churretera"
causas_de_la_gripe|"causas de la gripe"
swine_flu|"swine flu"
Barriga|"Barriga"
cronic|"cronic"
trat|"trat"
tari|"tari"
Sofocación_(a)|"Sofocación (a)"
PANZA|"PANZA"
patogen|"patogen"
SIN_HAMBRE|"SIN HAMBRE"
endemia|"endemia"
Asqueada|"Asqueada"
tos|"tos"
gripa|"gripa"
FATIGADA|"FATIGADA"
infectados|"infectados"
hospital|"hospital"
cdc_atlanta|"cdc atlanta"
curar|"curar"
hambre|"hambre"
Salud|"Salud"
tapabocas|"tapabocas"
resfriado|"resfriado"
congestion|"congestion"
influenza_ah1n1|"influenza ah1n1"
porcina|"porcina"
sin_respiracion|"sin respiracion"
cuid|"cuid"
muert|"muert"
boc|"boc"
asco|"asco"
COYUNTURAS|"COYUNTURAS"
agud|"agud"
MAREADA|"MAREADA"
influenza_virus|"influenza virus"
subtip|"subtip"
recet|"recet"
Sin_aire|"Sin aire"
rimantadina|"rimantadina"
para_el_dolor_de_garganta|"para el dolor de garganta"
diarre|"diarre"
barbijo|"barbijo"
defens|"defens"
remal|"remal"
Achaques|"Achaques"
duele|"duele"
cerd|"cerd"
jone|"jone"
sufr|"sufr"
cdc.gov|"cdc.gov"
estornud|"estornud"
enfermedad|"enfermedad"
DECAIDA|"DECAIDA"
nariz|"nariz"
swine|"swine"
victim|"victim"
broncopulmonar|"broncopulmonar"
afect|"afect"
pestes|"pestes"
Temblores_de_cuerpo|"Temblores de cuerpo"
musculos|"musculos"
h1n1|"h1n1"
gargant|"gargant"
circul|"circul"
doctor|"doctor"
limpi|"limpi"
SOÑOLIENTA|"SOÑOLIENTA"
influenza|"influenza"
superfici|"superfici"
irrit|"irrit"
wwe_backlash|"wwe backlash"
complic|"complic"
estacional|"estacional"
pech|"pech"
virus|"virus"
med|"med"
nasal|"nasal"
Espasmos|"Espasmos"
epidemi|"epidemi"
pandemic|"pandemic"
Desgano|"Desgano"
pulmon|"pulmon"
transmision|"transmision"
transmit|"transmit"
mucosidad_nasal|"mucosidad nasal"
Gomito|"Gomito"
goteo|"goteo"
preven|"preven"
lysol|"lysol"
amoxicilina|"amoxicilina"
cdc|"cdc"
bajón |"bajón "
temperatur|"temperatur"
laboratori|"laboratori"
backlash_2009|"backlash 2009"
zanamivir|"zanamivir"
recomiend|"recomiend"
pandemia|"pandemia"
prueb|"prueb"
mortal|"mortal"
Cagadera|"Cagadera"
agripado|"agripado"
Cansado|"Cansado"
retroviral|"retroviral"
respir|"respir"
flojera|"flojera"
vaporub|"vaporub"
sanitaria|"sanitaria"
estomago|"estomago"
Tritones|"Tritones"
corazón|"corazón"
sintomas|"sintomas"
respiratorias|"respiratorias"
oseltamivir|"oseltamivir"
viral|"viral"
flu|"flu"
propag|"propag"
anticuerp|"anticuerp"
proteccion|"proteccion"
porcine|"porcine"
dosis|"dosis"
lav|"lav"
caravanas_de_salud|"caravanas de salud"
secrecion|"secrecion"
torax|"torax"
Mate|"Mate"
control|"control"
pacient|"pacient"
Suelta|"Suelta"
inmuniz|"inmuniz"
antibioticos|"antibioticos"
gripe|"gripe"
consum|"consum"
toser|"toser"
influenza_tipo_b|"influenza tipo b"
destapada|"destapada"
Pálpitos|"Pálpitos"
Calambres|"Calambres"
world_health_organization|"world health organization"
nauseas|"nauseas"
HUESOS|"HUESOS"
remedi|"remedi"
HINCHADA|"HINCHADA"
medicamento|"medicamento"
agua|"agua"
inmun|"inmun"
cuerp|"cuerp"
aire|"aire"
para_la_tos|"para la tos"
COLICOS|"COLICOS"
Calentura|"Calentura"
cubreboca|"cubreboca"
antigripal|"antigripal"
alivi|"alivi"
Ritmo_cardíaco_irregular(_arritmia)|"Ritmo cardíaco irregular( arritmia)"
Sin_animo|"Sin animo"
Votar_tripas|"Votar tripas"
vick_vaporub|"vick vaporub"
Convulsiones|"Convulsiones"
recuper|"recuper"
apetito|"apetito"
antibiot|"antibiot"
nariz_tapada|"nariz tapada"
retorcijon|"retorcijon"
vacuna|"vacuna"
letargo|"letargo"
articulares|"articulares"
letargia|"letargia"
emergencia|"emergencia"
lysoform|"lysoform"
vomit|"vomit"
Arrojar|"Arrojar"
Jaqueca|"Jaqueca"
gripal|"gripal"
debilidad|"debilidad"
